ywh: pup
xye: mky roo
pbs: ses adw
rwh: ccg
qps: bcc
qbd: kjm vqu gtl bsi
pyx: dsk
dmc: ruq blj gku
lmi: yix usb qbd
usb: bsi gtl vqu kjm
cem: iwk dek uov
vfd: gig zmg gxn hoq
pyo: you gwd pup
jyz: ili
lvk: uaq dxr yer bzo
zsh: bzo
tdh: hlp uff mza
nqr: abx qtr eob
zed: wwh abx qtr eob
wod: ili otj
vzv: hpw dxr yer
nok: ysw nvp
blj: rfc
ili: jzw gxc lgn wor
xpe: hpw
zbb: nhp xip bxe kcz
mrz: iva hem bgl
mcl: vnx crj nav
gdj: wef ozr vxo
gun: znl pvg ukh jyc
jiv: pvr egv yxo
xih: out
fjn: wsj zmy
uds: kha ztr blr
ubz: fht
gup: abx wwh
hjk: gig zmg hoq
txg: fdn cem
nyh: hwh xqg scu evs
nds: dlt usb
jch: ivh zbb
izx: wef ozr vxo gsk
kpz: fft jou
ibp: zus
qtr: bne ouq mgy fjn ayg fme vcb rpo jmq tqu
lgn: ukh pvg jyc
yce: gwd you pup
ufk: wuc bsj onc
vis: zmg hoq
bcc: nqr gup
ebb: skd
igl: cbj mfs
pws: vxo ozr wef
gtl: uaq
hsx: gif khk xeu nok psj
xmt: cav txg gxq sxu jce
axj: rqi mgr pjg
cav: fdn klp
goa: xye fcj cfx
vhi: out
dtf: fft
wap: wuc onc
vqu: bzo yer dxr
jou: rrx jsk kpp
psj: ysw frv nvp
ipt: inw
woi: hon rwh aln
qxy: szq
azh: goa jie tlf qer
qec: bim btu xup
iwk: wwh abx eob
psh: gwd pup
nrd: clg jpd ilf dan igl
mgo: rsj rqo def
dxr: bco jre tay och ruf lat pxl zal nnl idx dhz wil uku uds mgo kpj syx
ohy: qtr eob abx
bme: gwd pup
nlk: nwd
vnx: teg xih vee
wma: bim btu xup
gxn: out
jxm: rzh fez yec edg
nfe: rnm
znl: hjc jch izx lgc gdj hlu rhn oam qxy izd kpz cui zih ebb pws qyu dgb udx dtf rvs ecl ejb xfj yjs njx xmt oqv
evm: mfm pul kef
pfh: wuc
mlz: oge rtw qrs xnl ubz
fft: rrx jsk
aiw: qtr eob abx
nwd: jyc ukh
yjs: jce txg sxu
nhj: dxr yer hpw
azb: onc wuc
jbx: uaq hpw dxr bzo
mwc: fcj igq
hlu: dsj dmc
qpt: zsh vcm zth
mxh: wsi esc rnm
onc: typ iht rim jjj dkw gkr noq mbw dge nyh scy sdd nfe eak qou lbj ugn mxh exi the vkb mxo pbg npo dxc
mkc: ilx
fre: dny cgl
smx: smo jyc
cxw: jjn gep lxi
gif: nvp
qgq: abx wwh eob qtr
rqi: jgd exv qdz azc
pnr: bbj dac eop cjq yov
mza: lif xfu
wsi: mlo vgp
ouq: mxm
vkb: scx wvg bhn
xfh: quk
qgm: alm gep
mgr: exv
wor: pvg smo jyc
bcb: oup bmh
exi: bfl ilg
lhb: bzm rzi rpz
rhn: oyw ivh
teg: out
oge: tef lhb
dtr: qer
mfm: ffm apr dqr
mho: ems
nhp: gvo tjb rab zed
roo: snw
jpd: cbj mfs mcp
apr: ofk
bfl: jxm quk xef
fcj: tfu
gig: out
czi: pup gwd
quk: edg fez rzh
fez: qnq
bco: pfy
xeo: ilf clg jpd igl
rpy: fnb gbx
gbs: boe zcz cif
vcr: csw
pbr: wuc onc
pgz: ilx pjg mgr wyv rqi
njx: twf
skd: gku
hoa: onc wuc
tqu: hem iva
lxi: yer
yxg: out
wnv: you pup
lbj: pyx nze
yix: bsi xpe
wef: knl lwm atz xxt
ztj: tlf
nqc: hux cws osp
bgp: pvg znl
pup: sul uvx nlp jik csm lhz gcu sgh evm fai wdl ofq shd
cms: pfh
khk: frv
uvx: tuu
xnl: lsf tef
wdl: wqi
jce: cem
oob: cms wsc ses wqp
zbl: ccd dff rjl bvq
dgb: gxq cav txg
eww: out
clg: mfs
qdz: ukh jyc smo
slk: pfs gbs cbr
csm: lbr ibz hbe xqu qwq
zmy: lmi kqh nds zei
bsi: bzo
lwm: wwh abx qtr eob
jjn: yer dxr
jie: igq cfx
dds: wnd zth zsh vcm
gku: rfc oca
kjm: yer
muf: bmh
fkm: ilx rqi mgr pjg
jzw: pvg znl
cec: goa jie qer
bgl: dbx cxw
cbj: smx gun
cws: rmb cxa hck xwf
rzh: yce
mbw: lvd wvg pnr
dlo: ccd
uku: pfy
pjg: azc qdz exv jgd hct
oam: twf tpq bdr
hbe: kez
oei: dds qpt
rsc: you
ygt: nnn ysy avw
brl: rjl dff elv
wvg: yov
cif: tno rtj qat
gio: zku vzv lvk zkg
esc: vml
tlf: fcj xye
xfu: uue rhe mmi
kko: whm
evs: mxl
eas: yxo egv
iva: buj yxa cxw
kmi: pvg ukh jyc
xqg: yii iqm
mcp: smx gun lpo yel
scx: yov cjq eop bbj
lry: taj nhj
jmq: qpt dds
bsj: qou lbj eak nfe vkb the mxo pbg dxc npo ugn mxh exi iht rim typ mbw nyh sdd wrg scy jjj noq
mjw: cug
bxs: wnd
mky: lmv
wgu: iid mza hlp uff
tfa: ubn jxo pbs rbc
xwf: out
ffm: mcl ofk oti
oup: pbr zxr alp
fht: rpz rzi
xxt: qtr eob abx
yyl: sqy
hck: out
tdi: cgl dny
ivt: hwp mmi
qjl: amo khi pgz jmk chc jyz dtr ztj cec axj wod nso uhm pee yqn azh uuo szb
nnl: rqo mlz
qer: cfx igq
nah: jxm quk uwd
ldn: smo jyc znl pvg ukh
wqp: hoa
xfj: wef vxo gsk
jxo: wsc
fhk: xeo
qvu: wor jzw lgn
atz: abx wwh eob qtr
wwh: rpo tqu fbp lcy mgy mrz ygt wma
ytg: abx
pft: out
zxr: wuc bsj onc
wuc: rim iht typ scy wrg dge nyh noq gkr dkw lbj qou nfe eak pbg npo dxc the vkb mxo mxh exi ugn
kgm: yqx
lvd: dac yov cjq
rwg: uwd xef
uov: qtr wwh
dhz: tfa kha
izd: vni dsj dmc
svi: gig
ayg: btu bim xup lry
boe: tno
rab: abx qtr eob
rzn: bxs dds
vni: blj
oyw: qfg nhp bxe kcz
hlp: lif nia ivt xfu
exv: jyc
rpz: onc
hem: cxw buj qgm
cxc: sfp
qyu: bjj
gep: bzo hpw yer dxr
ckl: svi vll vis hjk
pbh: hon aln rwh
iid: nia xfu
dlt: xpe vqu gtl bsi
qzp: you pup
cbr: cif ekl
tjb: abx wwh eob
sul: gkz zbl ccb
zcz: rtj qat mjw ibp tno
kpj: muf
lsf: rpz
zth: yer dxr hpw
uwd: fez
hal: bsj
pyb: wuc bsj
dge: ufg zhc
ilx: qdz hct jgd
kef: apr
nnn: lvk jbx vzv
pfs: ekl
lpo: ukh znl smo jyc
hjc: vxo wef gsk
scy: bhn lvd scx
mgy: hem
lmv: jyc smo
hwp: you
bmh: alp qoz
lbr: kez
urn: khi eas jmk fkm amo dtr cec jiv jyz uhm aup wod mkc azh szb uuo pee jay
uoe: ype csw bme
gxq: fdn klp cem
ruq: rfc oca qgq
shd: xqu qwq lbr hbe
btu: taj
noq: xfh
ais: out
szq: jsk
ilf: mcp
klp: iwk uov
vll: gig sxp gxn
egv: niq ldn
ccb: rjl
zfx: xeo nrd vyl
iyc: you
wnd: uaq yer
syx: whm yqx hsx
piy: cws
ccg: nqc piy
gsp: pup you gwd
kqh: yix dlt
rbc: wqp ses cms adw
rfm: nia lif xfu
gbh: yer bzo
zih: dsj vni
mgh: hjj
lat: bcb muf
rpm: out
fbp: zmy wsj
qmi: fnb hjj
ztr: oob ubn
nze: dsk uoe vcr
ofk: nav
sxp: out
nvp: azb
buj: lxi alm
mxl: xpf qzp cgr hsm
xqu: rhf ipt
jik: pul mfm kef
vgp: you
knl: abx qtr eob
szb: vyl xeo
edg: qnq czi yce
hjj: pft wfq
dan: cbj mcp
jre: dnw pfy
crj: xih
xpf: pup
zus: out
uah: xqu ibz
kcz: zed rab gvo ytg tjb
dbx: jjn
pee: fre yaf tdi
bzm: wuc
wil: olb hsx
rsy: bcc
gsk: lwm ohy atz xxt
xeu: frv ysw
mxm: buj cxw
trt: ffm lgj
gbx: vhi wfq
kpp: eob qtr
xip: tjb rab
ype: pup gwd
gwd: uah jik pbh sgh efl csm woi lhz gcu hqq fai wdl ofq shd izp rqj evm owq
nso: yaf tdi nlk lse fre
gxc: smo znl pvg ukh
yaf: nwd
jay: lse
ejb: fft
twf: aiw gup
mxo: nze pyx zhc
uhm: ili
pna: mwh yyl piy
lgj: ofk
bxe: rab zed gvo tjb
bvq: lmm rpy
vml: gwd pup
gcu: hbe
wrg: xnd scu xqg hwh
zhc: vcr uoe dsk
uaq: jre och tay kgm bco pxl nev lat ruf idx wil dhz kko nnl zal syx uku kpj uds hbw
nia: wnv rhe uue mmi hwp
zkg: dxr yer hpw
xnd: iqm
alp: wuc bsj
nlp: rwh mho
dac: gsp psh ojh iyc ywh
jnj: sfp ypk
gkz: elv dff rjl bvq
bdr: gup nqr aiw
sxu: klp
wfq: out
fnb: pft ais
hoq: out
tpq: nqr aiw
frv: hal
pul: ffm dqr lgj
mlo: you pup
sfp: pbr
pfy: wap jae
ysc: ilf igl
bzo: ruf pxl lat nev bco tay kgm jre kpj hbw uds nnl zal wil dhz idx
mmi: gwd
vyl: jpd igl dan
udx: ivh
rhf: ckl inw
adw: pfh pyb
hon: pna ccg ems
azc: znl smo
hsm: gwd
yer: syx uku mgo hbw idx wil dhz nnl pxl nev ruf jre och kgm tay bco
cgr: gwd you pup
ysy: zkg jbx vzv zku
cgl: znl pvg ukh jyc smo
lmm: gbx
rqj: ibz
udu: nnn ysy avw gio
dwk: rfm mza hlp
cug: out
rrx: abx wwh qtr
eop: psh iyc
tzt: hlp mza rfm iid
vcb: wsj haz
yii: xpf
mfs: smx lpo yel
ioc: out
ufg: dsk dru vcr
pxl: psk dnw pfy
scu: yii iqm
hct: znl pvg ukh smo
hrz: yix usb qbd
ufd: dlc
fme: iva bgl mxm
aup: mwc goa
mwh: osp hux
dlc: hjk vfd
vxo: atz knl
sej: bgp lmv
pbg: rwg ilg nah
otj: wor kmi lgn gxc
pvg: dgb udx njx ecl jch oam pws yjs qyu
whm: gif
lcy: qpt bxs
haz: zei nds lmi kqh
amo: wyv mgr pjg
oqv: bjj
the: wsi rnm
och: jnj bcb
oti: vnx crj nav
zei: usb
dvo: rrx jsk
idx: kha tfa blr wzu
bbj: gsp ojh ywh
olb: psj khk gif
zku: bzo dxr yer uaq hpw
lkn: zcz boe
jjj: dwk wgu tdh tzt
qoz: bsj onc wuc
gvo: wwh abx eob
rtw: lhb fht tef
inw: svi vll vfd
wzu: oob jxo ubn pbs
yec: czi rsc yce qnq
dek: eob qtr abx wwh
rvs: twf tpq bdr
tta: chc jiv yqn szb ajz aup wod jmk zfx pgz
lgc: txg cav sxu gxq jce
def: oge qrs
qwx: hlp
hwh: iqm
igq: tfu roo sej mky
bne: gio avw ysy nnn
osp: cxa xwf hck
npo: nze zhc
ajz: pvr
iqm: xpf qzp hsm
zmg: out
dsk: bme ype pyo
ypk: qoz zxr alp
avw: zkg lvk vzv jbx
zal: rqo rsj mlz
uue: you gwd
oca: abx wwh eob
rpo: qpt bxs
hux: hck xwf rmb cxa eww
ecl: szq jou dvo
kez: inw
sdd: dwk wgu tdh qwx
you: izp rqj pej shd owq uvx jik efl lhz woi gcu pbh
jmk: ysc
sgh: mfm pul kef
rsj: rtw qrs xnl ubz
dsj: blj gku
ses: hoa pfh qdn
lif: mmi
yov: ojh
hpw: bco jre tay kgm och ruf lat pxl nev zal nnl kko idx wil dhz uku uds hbw mgo kpj
nev: def
yqn: qvu
yqx: nok khk gif psj
abx: qec bvz ouq ygt jmq tqu fme vcb ayg mgy wma oei
rmb: out
qou: nah xfh rwg
snw: jyc ukh
rqs: bsj wuc
ccd: rpy lmm
blr: rbc oob jxo ubn pbs
yxo: ldn niq urr
ozr: ohy lwm knl atz
tay: jnj cxc
urr: jyc
ems: mwh yyl piy
dxc: dwk qwx tdh
ysw: azb ufk hal
efl: brl dlo
niq: jyc smo ukh znl
lse: nwd
rhe: you gwd
bhn: bbj dac yov cjq
rzi: wuc onc bsj
dny: jyc smo znl pvg
uuo: nrd ysc vyl
jae: onc
cfx: mky roo
rtj: rpm ioc yxg cug
rku: fkm eas khi zfx pgz jmk jiv chc ztj ajz axj wod aup uhm pee fhk yqn uuo
ofq: trt
eob: vcb rpo udu ygt bvz oei rzn wma
dru: bme csw
rqo: oge
dkw: hwh xqg evs xnd scu
tuu: gbs cbr lkn
izp: gkz zbl dlo
taj: yer dxr uaq
chc: pvr yxo
uff: lif nia
yel: znl
cjq: iyc ywh gsp ojh
csw: you
alm: uaq yer dxr bzo
vee: out
hbw: psk
eak: dwk wgu tdh qwx
ibz: kez ipt ufd
hqq: tuu slk wqi
lhz: tuu
pej: kef mfm pul
qdn: wuc
gkr: ilg nah
iht: nze
smo: gdj hlu ejb rhn pws qyu qps qxy dtf ecl xmt
xup: gbh
typ: tzt dwk
ekl: qat ibp tno
ztf: jyz jiv chc ztj dtr fkm eas khi jay uuo azh mkc aup ajz cec amo pgz zfx jmk pee szb wod uhm
xef: fez rzh
qnq: pup you
elv: mgh
rnm: mlo vgp
bim: taj gbh
ukh: rvs lgc izd udx pws qyu cui hlu rsy
wsj: zei hrz kqh
ojh: you
qwq: ufd rhf
kha: oob pbs jxo ubn
rjl: mgh qmi rpy
bjj: qfg xip
sqy: xwf
cxa: out
ruf: jnj
wyv: hct azc qdz
wsc: hoa pfh
ugn: pnr scx lvd wvg bhn
svr: qjl ztf rku tta urn
jyc: xfj yjs ejb xmt oqv njx qyu cui ebb rsy dtf ecl rvs dgb udx oam hlu gdj rhn kpz izd qxy izx jch lgc
tfu: lmv
vcm: bzo yer dxr hpw uaq
tno: rpm ioc yxg zus
fdn: uov dek iwk
jgd: smo jyc ukh pvg
nav: vee teg
fai: mho aln
qfg: ytg tjb rab zed
dqr: mcl oti
yxa: gep jjn
aln: pna ems ccg
rim: pnr lvd wvg bhn
qat: ioc rpm zus cug
ivh: nhp xip kcz bxe
bvz: avw gio nnn ysy
ubn: wqp cms ses wsc
tef: rzi rpz
cui: dmc skd dsj
khi: qvu otj ili
dnw: wap jae
owq: rwh hon
qrs: tef lhb lsf
rfc: abx
ilg: xef
jsk: qtr eob wwh abx
dff: qmi rpy
wqi: lkn
psk: rqs jae
pvr: urr
